.S.#######
#........#
#.###.##.#
#.#....#.#
#.#..#.#.#
#.##.#####
#.#......#
#.#.#..#.#
#####.####
#...#....X
#.#....#.#
##########